****************
*     *     *  *
****  *  *  *  *
*  *     *     *
*  *  ****  ****
*     *  *  *  *
****  *  *  *  *
*     *  *     *
*  *  ****  *  *
*  *        *   
****************
1
7